figlet-ts FTW!
  ___        _______ _____       _        _       _       _  __ 
 | \ \      / /_   _|  ___|  ___| |_     | |_ ___| | __ _(_)/ _|
 | |\ \ /\ / /  | | | |_    / __| __|____| __/ _ \ |/ _` | | |_ 
 |_| \ V  V /   | | |  _|   \__ \ ||_____| ||  __/ | (_| | |  _|
 (_)  \_/\_/    |_| |_|     |___/\__|     \__\___|_|\__, |_|_|  
                                                    |___/       