figlet-ts FTW!
    _____       __     __        __          _____________       ____
   / __(_)___ _/ /__  / /_      / /______   / ____/_  __/ |     / / /
  / /_/ / __ `/ / _ \/ __/_____/ __/ ___/  / /_    / /  | | /| / / / 
 / __/ / /_/ / /  __/ /_/_____/ /_(__  )  / __/   / /   | |/ |/ /_/  
/_/ /_/\__, /_/\___/\__/      \__/____/  /_/     /_/    |__/|__(_)   
      /____/                                                         