figlet-ts FTW!
  __ _       _      _        _         _____ _______        ___ 
 / _(_) __ _| | ___| |_     | |_ ___  |  ___|_   _\ \      / / |
| |_| |/ _` | |/ _ \ __|____| __/ __| | |_    | |  \ \ /\ / /| |
|  _| | (_| | |  __/ ||_____| |_\__ \ |  _|   | |   \ V  V / |_|
|_| |_|\__, |_|\___|\__|     \__|___/ |_|     |_|    \_/\_/  (_)
       |___/                                                    