figlet-ts FTW!
       _ __        __ _____  _____        _          _         _         _   __ 
      | |\ \      / /|_   _||  ___|  ___ | |_       | |_  ___ | |  __ _ (_) / _|
      | | \ \ /\ / /   | |  | |_    / __|| __|_____ | __|/ _ \| | / _` || || |_ 
      |_|  \ V  V /    | |  |  _|   \__ \| |_|_____|| |_|  __/| || (_| || ||  _|
      (_)   \_/\_/     |_|  |_|     |___/ \__|       \__|\___||_| \__, ||_||_|  
                                                                  |___/         