figlet-ts FTW!
    ____ _         __       __          __           ______ ______ _       __ __
   / __/(_)____ _ / /___   / /_        / /_ _____   / ____//_  __/| |     / // /
  / /_ / // __ `// // _ \ / __/______ / __// ___/  / /_     / /   | | /| / // / 
 / __// // /_/ // //  __// /_ /_____// /_ (__  )  / __/    / /    | |/ |/ //_/  
/_/  /_/ \__, //_/ \___/ \__/        \__//____/  /_/      /_/     |__/|__/(_)   
        /____/                                                                  